21; 21; 21; 21; 21; 21; 21; 21; 22; 27; 21; 21; 21; 21; 21; 21; 21; 21; 21; 21; 21; 21; 21; 21; 21
21; 21; 21; 21; 21; 21; 21; 21; 24; 29; 21; 21; 21; 21; 21; 21; 21; 21; 21; 21; 21; 21; 21; 21; 21
21; 21; 21; 21; 21; 21; 21; 21; 21; 21; 21; 21; 21; 21; 21; 21; 21; 21; 21; 21; 21; 21; 21; 21; 21
21; 21; 21; 21; 21; 21; 21; 21; 21; 21; 21; 21; 21; 21; 21; 21; 21; 21; 21; 21; 22; 25; 27; 21; 21
25; 25; 25; 25; 27; 21; 21; 21; 21; 21; 21; 21; 21; 21; 21; 21; 21; 21; 21; 21; 23; 13; 32; 25; 25
13; 13; 13; 13; 32; 25; 25; 25; 25; 25; 25; 25; 25; 25; 25; 25; 25; 25; 25; 25; 30; 13; 45; 38; 38
13; 13; 13; 13; 13; 13; 13; 13; 13; 13; 13; 13; 13; 13; 13; 13; 13; 13; 13; 13; 13; 13; 40; 50; 52
13; 13; 13; 13; 13; 13; 13; 13; 13; 13; 13; 13; 13; 13; 13; 13; 13; 92; 13; 13; 13; 13; 40; 50; 54
13; 13; 13; 13; 13; 13; 13; 13; 13; 13; 13; 13; 13; 13; 13; 13; 13; 13; 13; 13; 13; 13; 44; 37; 37
13; 13; 13; 13; 13; 13; 13; 13; 13; 13; 13; 13; 13; 13; 13; 13; 13; 13; 13; 13; 13; 13; 13; 13; 13
13; 13; 13; 13; 13; 13; 13; 13; 13; 13; 13; 13; 13; 13; 13; 13; 13; 13; 13; 13; 13; 13; 13; 13; 13
13; 13; 13; 13; 13; 13; 13; 13; 13; 13; 13; 13; 13; 13; 13; 13; 13; 13; 13; 13; 13; 13; 13; 13; 13
13; 13; 13; 13; 13; 13; 13; 13; 13; 13; 13; 13; 13; 13; 13; 13; 13; 13; 13; 13; 13; 13; 13; 13; 13
13; 13; 13; 13; 13; 13; 13; 13; 13; 13; 13; 13; 13; 13; 13; 13; 13; 13; 13; 13; 13; 13; 13; 13; 13
13; 13; 13; 13; 13; 13; 13; 13; 13; 13; 13; 13; 13; 13; 13; 13; 13; 13; 13; 13; 13; 13; 13; 13; 13
13; 13; 13; 13; 13; 13; 13; 13; 13; 13; 13; 13; 13; 13; 13; 13; 13; 13; 13; 13; 13; 13; 13; 13; 13
13; 13; 13; 13; 13; 13; 13; 13; 13; 13; 13; 13; 13; 13; 13; 13; 13; 13; 13; 13; 13; 13; 13; 13; 13
13; 13; 13; 13; 13; 13; 13; 13; 13; 13; 13; 13; 13; 13; 13; 13; 13; 13; 13; 13; 13; 13; 13; 13; 13
13; 13; 13; 13; 13; 13; 13; 13; 13; 13; 13; 13; 13; 13; 13; 13; 13; 13; 13; 13; 13; 13; 13; 13; 13
13; 13; 13; 13; 13; 13; 13; 13; 13; 13; 13; 13; 13; 13; 13; 13; 13; 13; 13; 13; 13; 13; 13; 13; 13
13; 13; 13; 13; 13; 13; 13; 13; 13; 13; 13; 13; 13; 13; 13; 13; 13; 13; 13; 13; 13; 13; 13; 13; 13
13; 13; 13; 13; 13; 13; 13; 13; 13; 13; 13; 13; 13; 13; 13; 13; 13; 13; 13; 13; 13; 13; 13; 13; 13
13; 13; 13; 13; 13; 13; 13; 13; 13; 13; 13; 92; 13; 13; 13; 13; 13; 13; 13; 13; 13; 13; 13; 13; 13
13; 13; 13; 13; 13; 13; 13; 13; 13; 13; 13; 13; 13; 13; 13; 13; 13; 13; 13; 13; 13; 13; 13; 13; 13
13; 13; 13; 13; 13; 13; 13; 13; 13; 13; 13; 13; 13; 13; 13; 13; 13; 13; 13; 13; 13; 13; 13; 13; 13
13; 13; 13; 13; 13; 13; 13; 13; 13; 13; 13; 13; 13; 13; 13; 13; 13; 13; 13; 13; 13; 13; 13; 13; 13
13; 13; 13; 13; 13; 13; 13; 13; 13; 13; 13; 13; 13; 13; 13; 13; 13; 13; 13; 13; 92; 13; 13; 13; 13
13; 13; 13; 13; 13; 13; 13; 13; 13; 13; 13; 13; 13; 13; 13; 13; 13; 13; 13; 13; 13; 13; 13; 13; 13
13; 13; 13; 13; 13; 13; 13; 13; 13; 13; 13; 13; 13; 13; 13; 13; 13; 13; 13; 13; 13; 13; 13; 13; 13
13; 13; 13; 13; 13; 13; 13; 13; 13; 13; 13; 13; 13; 13; 13; 13; 13; 13; 13; 13; 13; 13; 13; 13; 13
13; 13; 13; 13; 13; 13; 13; 13; 13; 13; 13; 13; 13; 13; 13; 13; 13; 13; 13; 13; 13; 13; 13; 13; 13
13; 13; 13; 13; 13; 13; 13; 13; 13; 13; 13; 13; 13; 13; 13; 13; 13; 13; 13; 13; 13; 13; 13; 13; 13
13; 13; 13; 13; 13; 13; 13; 13; 13; 13; 13; 13; 13; 13; 13; 13; 13; 13; 13; 13; 13; 13; 13; 13; 13
13; 13; 13; 13; 13; 13; 13; 13; 13; 13; 13; 13; 13; 13; 13; 13; 13; 13; 13; 13; 13; 13; 13; 13; 13
13; 13; 13; 13; 13; 13; 13; 13; 13; 13; 13; 13; 13; 13; 13; 13; 13; 13; 13; 13; 13; 13; 13; 13; 13
13; 13; 13; 13; 13; 13; 13; 13; 13; 13; 13; 13; 13; 13; 13; 13; 13; 13; 13; 13; 13; 13; 13; 13; 13
13; 13; 13; 13; 13; 13; 13; 13; 13; 13; 13; 13; 13; 13; 13; 13; 13; 13; 13; 13; 13; 13; 13; 13; 13
13; 13; 13; 13; 13; 13; 13; 13; 13; 13; 13; 13; 13; 13; 13; 92; 13; 13; 13; 13; 13; 13; 13; 13; 13
13; 13; 13; 13; 13; 13; 13; 13; 13; 13; 13; 13; 13; 13; 13; 13; 13; 13; 13; 13; 13; 13; 13; 13; 13
13; 13; 13; 13; 13; 13; 13; 13; 13; 13; 13; 13; 13; 13; 13; 13; 13; 13; 13; 13; 13; 13; 13; 13; 13
13; 13; 13; 13; 13; 13; 13; 13; 13; 13; 13; 13; 13; 13; 13; 13; 13; 13; 13; 13; 13; 13; 13; 13; 13
13; 13; 13; 13; 13; 13; 13; 13; 13; 13; 13; 13; 13; 13; 13; 13; 13; 13; 13; 13; 13; 13; 13; 13; 13
13; 13; 13; 13; 13; 13; 13; 13; 13; 13; 13; 13; 13; 13; 13; 13; 13; 13; 13; 13; 13; 13; 13; 13; 13
13; 13; 13; 13; 13; 13; 13; 13; 13; 13; 13; 13; 13; 13; 13; 13; 13; 13; 13; 13; 13; 13; 13; 13; 13
13; 13; 13; 13; 13; 13; 13; 13; 13; 13; 13; 13; 13; 13; 13; 13; 13; 13; 13; 13; 13; 13; 13; 13; 13
13; 13; 13; 13; 13; 13; 13; 13; 13; 13; 13; 13; 13; 13; 13; 13; 13; 13; 13; 13; 13; 13; 13; 13; 13
13; 13; 13; 13; 13; 13; 13; 13; 13; 13; 13; 13; 13; 13; 13; 13; 13; 13; 13; 13; 13; 13; 13; 13; 13
13; 13; 13; 13; 13; 13; 13; 13; 13; 13; 13; 13; 13; 13; 13; 13; 13; 13; 13; 13; 13; 13; 13; 13; 13
13; 13; 13; 13; 13; 13; 13; 13; 13; 13; 13; 13; 13; 13; 13; 13; 13; 13; 13; 13; 13; 13; 13; 13; 13
13; 13; 13; 13; 13; 13; 13; 13; 13; 13; 13; 13; 13; 13; 13; 13; 13; 13; 13; 13; 13; 13; 13; 13; 13
13; 13; 13; 13; 13; 13; 13; 13; 13; 13; 92; 13; 13; 13; 13; 13; 13; 13; 13; 13; 13; 13; 13; 13; 13
13; 13; 13; 13; 13; 13; 13; 13; 13; 13; 13; 13; 13; 13; 13; 13; 13; 13; 13; 13; 13; 13; 13; 13; 13
13; 13; 13; 13; 13; 13; 13; 13; 13; 13; 13; 13; 13; 13; 13; 13; 13; 13; 13; 13; 13; 13; 13; 13; 13
13; 13; 13; 13; 13; 13; 13; 13; 13; 13; 13; 13; 13; 13; 13; 13; 13; 13; 13; 13; 13; 13; 13; 13; 13
13; 13; 13; 13; 13; 13; 13; 13; 13; 13; 13; 13; 13; 13; 13; 13; 13; 13; 13; 13; 13; 13; 13; 13; 13
13; 13; 13; 13; 13; 13; 13; 13; 13; 13; 13; 13; 13; 13; 13; 13; 13; 13; 13; 13; 13; 13; 13; 13; 13
13; 13; 13; 13; 13; 13; 13; 13; 13; 13; 13; 13; 13; 13; 13; 13; 13; 13; 13; 13; 92; 13; 13; 13; 13
13; 13; 13; 13; 13; 13; 13; 13; 13; 13; 13; 13; 13; 13; 13; 13; 13; 13; 13; 13; 13; 13; 13; 13; 13
13; 13; 13; 13; 13; 13; 13; 13; 13; 13; 13; 13; 13; 13; 13; 13; 13; 13; 13; 13; 13; 13; 13; 13; 13
13; 13; 13; 13; 13; 13; 13; 13; 13; 13; 13; 13; 13; 13; 13; 13; 13; 13; 13; 13; 13; 13; 13; 13; 13
13; 13; 13; 13; 13; 13; 13; 13; 13; 13; 13; 13; 13; 13; 13; 13; 13; 13; 13; 13; 13; 13; 13; 13; 13
13; 13; 13; 13; 13; 13; 13; 13; 13; 13; 13; 13; 13; 13; 13; 13; 13; 13; 13; 13; 13; 13; 13; 13; 13
13; 13; 13; 13; 13; 13; 13; 13; 13; 13; 13; 13; 13; 13; 13; 13; 13; 13; 13; 13; 13; 13; 13; 13; 13
13; 13; 13; 13; 13; 13; 13; 13; 13; 13; 13; 13; 13; 13; 13; 13; 13; 13; 13; 13; 13; 13; 13; 13; 13
13; 13; 13; 13; 13; 13; 13; 13; 13; 13; 13; 13; 13; 13; 13; 13; 13; 13; 13; 13; 13; 13; 13; 13; 13
13; 13; 13; 13; 13; 13; 13; 13; 13; 13; 13; 13; 13; 13; 13; 13; 13; 13; 13; 13; 13; 13; 13; 13; 13
13; 13; 13; 13; 13; 13; 13; 13; 13; 13; 13; 92; 13; 13; 13; 13; 13; 13; 13; 13; 13; 13; 13; 13; 13
13; 13; 13; 13; 13; 13; 13; 13; 13; 13; 13; 13; 13; 13; 13; 13; 13; 13; 13; 13; 13; 13; 13; 13; 13
13; 13; 13; 13; 13; 13; 13; 13; 13; 13; 13; 13; 13; 13; 13; 13; 13; 13; 13; 13; 13; 13; 13; 13; 13
13; 13; 13; 13; 13; 13; 13; 13; 13; 13; 13; 13; 13; 13; 13; 13; 13; 13; 13; 13; 13; 13; 13; 13; 13
13; 13; 13; 13; 13; 13; 13; 13; 13; 13; 13; 13; 13; 13; 13; 13; 13; 13; 13; 13; 13; 13; 13; 13; 13
13; 13; 13; 13; 13; 13; 13; 13; 13; 13; 13; 13; 13; 13; 13; 13; 13; 13; 13; 13; 13; 13; 13; 13; 13
13; 13; 13; 13; 13; 13; 13; 13; 13; 13; 13; 13; 13; 13; 13; 13; 13; 13; 13; 13; 13; 13; 13; 13; 13
13; 13; 13; 13; 13; 13; 13; 13; 13; 13; 13; 13; 13; 13; 13; 13; 13; 13; 13; 13; 13; 13; 13; 13; 13
13; 13; 13; 13; 13; 13; 13; 13; 13; 13; 13; 13; 13; 13; 13; 13; 13; 13; 13; 13; 13; 13; 13; 13; 13
13; 13; 13; 13; 13; 13; 13; 13; 13; 13; 13; 13; 13; 13; 13; 13; 13; 13; 13; 13; 13; 13; 13; 13; 13
13; 13; 13; 13; 13; 13; 13; 13; 13; 13; 13; 13; 13; 13; 13; 13; 13; 13; 13; 13; 13; 13; 13; 13; 13
13; 13; 13; 13; 13; 13; 13; 13; 13; 13; 13; 13; 13; 13; 13; 13; 13; 13; 13; 92; 13; 13; 13; 13; 13
13; 13; 13; 13; 13; 13; 13; 13; 13; 13; 13; 13; 13; 13; 13; 13; 13; 13; 13; 13; 13; 13; 13; 13; 13
13; 13; 13; 13; 13; 13; 13; 13; 13; 13; 13; 13; 13; 13; 13; 13; 13; 13; 13; 13; 13; 13; 13; 13; 13
13; 13; 13; 13; 13; 13; 13; 13; 13; 13; 13; 13; 13; 13; 13; 13; 13; 13; 13; 13; 13; 13; 13; 13; 13
13; 13; 13; 13; 13; 13; 13; 13; 13; 13; 13; 13; 13; 13; 13; 13; 13; 13; 13; 13; 13; 13; 13; 13; 13
13; 13; 13; 13; 13; 13; 13; 13; 13; 13; 13; 13; 13; 13; 13; 13; 13; 13; 13; 13; 13; 13; 13; 13; 13
13; 13; 13; 13; 13; 13; 13; 13; 13; 92; 13; 13; 13; 13; 13; 13; 13; 13; 13; 13; 13; 13; 13; 13; 13
13; 13; 13; 13; 13; 13; 13; 13; 13; 13; 13; 13; 13; 13; 13; 13; 13; 13; 13; 13; 13; 13; 13; 13; 13
13; 13; 13; 13; 13; 13; 13; 13; 13; 13; 13; 13; 13; 13; 13; 13; 13; 13; 13; 13; 13; 13; 13; 13; 13
13; 13; 13; 13; 13; 13; 13; 13; 13; 13; 13; 13; 13; 13; 13; 13; 13; 13; 13; 13; 13; 13; 13; 13; 13
13; 13; 13; 13; 13; 13; 13; 13; 13; 13; 13; 13; 13; 13; 13; 13; 13; 13; 13; 13; 13; 13; 13; 13; 13
21; 21; 21; 21; 21; 21; 21; 21; 21; 21; 21; 21; 21; 21; 21; 21; 93; 98; 98; 100; 21; 21; 21; 21; 21
21; 21; 21; 21; 21; 21; 21; 21; 21; 21; 21; 21; 21; 21; 21; 21; 94; 92; 92; 101; 21; 21; 21; 21; 93
21; 21; 21; 21; 21; 21; 21; 21; 21; 21; 21; 21; 21; 21; 21; 21; 95; 85; 85; 102; 21; 21; 21; 21; 94
21; 21; 21; 21; 21; 21; 21; 21; 21; 22; 25; 27; 21; 21; 21; 21; 96; 91; 91; 103; 21; 21; 21; 21; 95
21; 21; 21; 21; 21; 21; 21; 21; 22; 30; 13; 32; 27; 21; 21; 21; 97; 106; 106; 104; 21; 21; 21; 21; 96
21; 21; 21; 21; 21; 21; 21; 21; 23; 13; 111; 13; 28; 21; 21; 21; 21; 21; 21; 21; 21; 21; 21; 21; 96
21; 21; 21; 21; 21; 21; 21; 21; 23; 13; 13; 13; 28; 21; 21; 21; 21; 21; 21; 21; 21; 21; 21; 21; 97
21; 21; 21; 21; 21; 21; 21; 21; 24; 26; 26; 26; 29; 21; 21; 21; 21; 21; 21; 21; 21; 21; 21; 21; 21
21; 21; 21; 21; 21; 21; 21; 21; 21; 21; 21; 21; 21; 21; 21; 21; 21; 93; 98; 98; 98; 98; 98; 98; 98
25; 25; 25; 27; 21; 21; 21; 21; 21; 21; 21; 21; 21; 21; 21; 21; 21; 94; 46; 46; 46; 46; 46; 46; 46
5; 5; 10; 32; 25; 25; 25; 27; 21; 21; 21; 21; 22; 25; 25; 27; 21; 94; 46; 46; 46; 46; 71; 66; 66
16; 16; 3; 5; 5; 10; 13; 32; 25; 25; 25; 25; 30; 13; 13; 32; 25; 105; 46; 46; 46; 46; 46; 46; 46
18; 16; 16; 16; 16; 3; 5; 5; 10; 13; 13; 13; 13; 13; 13; 13; 13; 82; 92; 46; 92; 46; 92; 46; 92
16; 16; 16; 17; 16; 18; 19; 16; 2; 13; 111; 13; 13; 13; 13; 13; 13; 84; 85; 85; 85; 85; 85; 85; 85
63; 16; 16; 16; 16; 16; 16; 1; 9; 13; 13; 13; 13; 13; 13; 13; 13; 89; 91; 91; 91; 91; 91; 91; 91
16; 16; 16; 16; 1; 4; 4; 9; 13; 13; 13; 13; 13; 13; 13; 13; 13; 88; 87; 87; 87; 87; 87; 87; 87
4; 4; 4; 4; 9; 13; 111; 13; 13; 13; 13; 13; 13; 13; 13; 13; 13; 13; 13; 13; 13; 13; 13; 13; 13
13; 13; 13; 13; 13; 13; 13; 13; 12; 5; 5; 10; 13; 13; 13; 13; 13; 13; 13; 13; 13; 13; 13; 13; 13
26; 26; 26; 26; 26; 26; 31; 13; 7; 64; 16; 3; 5; 10; 13; 77; 66; 66; 66; 66; 66; 66; 66; 66; 66
21; 21; 21; 21; 21; 21; 23; 13; 7; 16; 16; 16; 16; 2; 13; 65; 13; 13; 48; 47; 47; 47; 47; 47; 47
25; 25; 25; 25; 27; 21; 23; 13; 7; 16; 20; 18; 16; 2; 13; 65; 13; 13; 82; 92; 46; 46; 92; 46; 46
38; 38; 38; 43; 28; 21; 23; 13; 7; 16; 16; 16; 16; 2; 13; 65; 13; 13; 82; 92; 46; 46; 92; 46; 46
50; 50; 50; 35; 28; 21; 23; 13; 11; 4; 4; 4; 4; 9; 13; 65; 13; 13; 84; 85; 85; 85; 85; 85; 85
50; 34; 37; 42; 28; 21; 23; 45; 38; 38; 38; 38; 38; 38; 43; 65; 13; 13; 89; 91; 91; 91; 91; 91; 91
37; 42; 33; 26; 29; 21; 23; 40; 52; 55; 55; 55; 55; 58; 35; 65; 13; 13; 88; 87; 87; 87; 87; 87; 87
33; 26; 29; 21; 22; 25; 30; 40; 53; 56; 56; 56; 56; 59; 35; 76; 66; 66; 66; 66; 66; 66; 66; 66; 66
29; 21; 22; 25; 30; 45; 38; 41; 54; 61; 56; 56; 56; 59; 35; 65; 13; 107; 109; 13; 107; 109; 13; 13; 13
21; 22; 30; 45; 38; 41; 50; 50; 50; 54; 57; 62; 57; 60; 35; 65; 13; 108; 110; 13; 108; 110; 13; 13; 13
21; 23; 13; 40; 50; 50; 50; 50; 50; 50; 34; 37; 37; 37; 42; 76; 66; 78; 78; 66; 78; 72; 13; 13; 13
25; 30; 13; 44; 37; 37; 37; 37; 37; 37; 42; 13; 13; 13; 77; 72; 13; 13; 13; 13; 13; 13; 13; 13; 13
13; 13; 13; 13; 13; 13; 13; 13; 13; 13; 12; 5; 5; 10; 65; 13; 13; 13; 13; 13; 13; 13; 13; 13; 33
13; 13; 13; 13; 13; 13; 13; 13; 12; 5; 8; 16; 16; 2; 65; 13; 13; 13; 13; 13; 13; 13; 13; 13; 28
13; 13; 13; 12; 5; 5; 5; 5; 8; 16; 16; 18; 16; 2; 65; 13; 13; 13; 13; 13; 13; 13; 13; 13; 28
13; 13; 13; 7; 18; 16; 16; 16; 16; 16; 16; 16; 16; 2; 65; 13; 13; 45; 38; 43; 13; 33; 26; 26; 29
13; 107; 109; 11; 4; 4; 6; 16; 19; 16; 16; 63; 1; 9; 76; 66; 67; 40; 50; 35; 13; 28; 21; 21; 21
13; 108; 110; 13; 13; 13; 7; 16; 16; 18; 16; 1; 9; 77; 72; 13; 13; 40; 50; 36; 43; 32; 27; 21; 21
13; 65; 65; 13; 13; 13; 11; 4; 4; 4; 4; 9; 13; 68; 13; 13; 45; 41; 50; 51; 36; 43; 28; 21; 21
66; 78; 78; 66; 66; 66; 66; 66; 66; 66; 66; 66; 66; 73; 13; 13; 40; 50; 50; 50; 50; 35; 28; 21; 21
5; 5; 10; 13; 13; 13; 13; 13; 13; 48; 47; 47; 49; 65; 13; 13; 44; 37; 37; 37; 37; 42; 32; 25; 25
16; 16; 3; 5; 10; 12; 5; 10; 13; 82; 46; 92; 81; 65; 13; 13; 13; 13; 13; 13; 13; 13; 13; 13; 12
16; 16; 16; 18; 3; 8; 1; 9; 13; 82; 92; 46; 81; 65; 13; 13; 13; 13; 13; 13; 13; 13; 12; 5; 8
64; 16; 16; 16; 1; 4; 9; 13; 13; 84; 85; 85; 83; 65; 13; 12; 5; 5; 10; 13; 13; 12; 8; 16; 17
16; 16; 1; 4; 9; 13; 13; 13; 13; 89; 91; 91; 90; 65; 13; 7; 16; 16; 2; 13; 13; 7; 16; 18; 16
4; 4; 9; 13; 13; 13; 13; 13; 13; 88; 87; 87; 86; 65; 13; 11; 4; 4; 9; 13; 13; 7; 16; 16; 18
13; 13; 13; 13; 13; 13; 45; 38; 38; 38; 43; 13; 13; 65; 13; 13; 13; 13; 13; 13; 13; 11; 4; 4; 4
111; 13; 33; 26; 31; 13; 40; 50; 51; 50; 35; 13; 13; 65; 13; 13; 45; 38; 38; 43; 13; 13; 13; 13; 13
13; 13; 28; 21; 24; 31; 40; 50; 50; 34; 42; 13; 13; 68; 13; 45; 41; 50; 50; 35; 13; 45; 38; 38; 38
13; 13; 32; 25; 25; 30; 44; 37; 37; 42; 13; 13; 13; 65; 13; 40; 50; 51; 50; 36; 38; 41; 50; 50; 50
38; 38; 38; 38; 38; 43; 13; 13; 13; 13; 77; 66; 66; 72; 13; 40; 50; 51; 50; 50; 52; 55; 55; 55; 55
51; 50; 52; 55; 58; 35; 13; 13; 13; 13; 65; 13; 13; 13; 13; 44; 39; 50; 50; 50; 53; 61; 61; 56; 56
55; 58; 53; 56; 59; 35; 13; 13; 13; 13; 65; 13; 13; 13; 13; 45; 41; 50; 50; 51; 53; 61; 61; 61; 61
56; 59; 54; 57; 60; 35; 13; 13; 13; 13; 65; 13; 13; 13; 13; 40; 50; 50; 50; 50; 54; 62; 57; 57; 62
62; 60; 50; 34; 37; 42; 13; 13; 13; 13; 68; 13; 13; 13; 13; 40; 50; 50; 50; 50; 50; 50; 50; 51; 50
51; 50; 50; 35; 13; 13; 13; 13; 13; 13; 65; 13; 13; 13; 13; 44; 37; 37; 37; 37; 37; 37; 37; 37; 37
37; 37; 37; 42; 13; 13; 13; 13; 13; 13; 65; 13; 13; 13; 13; 13; 13; 13; 13; 13; 13; 13; 13; 13; 13
47; 47; 47; 47; 47; 47; 47; 47; 47; 49; 65; 48; 47; 47; 47; 47; 47; 47; 47; 47; 47; 47; 47; 47; 47
46; 46; 46; 46; 46; 46; 46; 46; 46; 81; 65; 82; 46; 46; 46; 46; 46; 46; 46; 46; 46; 46; 46; 46; 46
